{
  "name": "Turn the Corner",
  "index": 2,
  "grid": [
    ["W","W","W","W","W","W","W","W"],
    ["W","S","F","F","F","W","W","W"],
    ["W","W","W","W","F","W","W","W"],
    ["W","W","W","W","F","W","W","W"],
    ["W","W","W","W","F","F","E","W"],
    ["W","W","W","W","W","W","W","W"]
  ]
}
