{
  "name": "The Gauntlet",
  "index": 2,
  "grid": [
    ["W","W","W","W","W","W","W","W","W","W","W","W","W","W"],
    ["W","S","F","F","F","W","F","F","F","F","F","F","F","W"],
    ["W","F","W","W","F","W","F","W","W","W","F","W","F","W"],
    ["W","F","F","F","F","F","F","F","F","W","F","W","F","W"],
    ["W","W","W","F","W","W","W","W","F","W","F","F","F","W"],
    ["W","F","F","F","F","F","Kr","W","F","F","F","W","W","W"],
    ["W","F","W","W","W","W","F","W","W","W","F","F","F","W"],
    ["W","F","F","F","F","F","F","Dr","F","F","F","W","F","W"],
    ["W","W","W","W","F","W","F","W","F","W","F","F","E","W"],
    ["W","W","W","W","W","W","W","W","W","W","W","W","W","W"]
  ]
}
